################################################
#                                              #
#                                              #
#                                              #
#                                              #
#                                              #
#                                              #
#                                              #
#                                              #
#                                  P           #
#                                              #
#                                              #
#                                              #
#                                              #
#                                              #
#                                              #
#            K                                 #
#                                              #
#                                              #
#                                              #
#                                              #
#                                              #
#                                              #
#                                              #
#                                              #
#                                              #
################################################